2 3 3 2 2 2 2 2 2 2 2 2 2 2 2 2 2 2 2 2 2 2 2 2 2 E
2 2 3 3 2 2 2 2 2 2 2 2 2 2 2 2 2 2 2 2 3 3 2 2 2 E
2 2 2 2 2 3 2 2 2 2 2 2 2 2 2 2 2 2 2 3 2 2 3 2 2 E
2 2 2 2 2 3 2 2 2 2 2 3 3 3 3 2 2 2 2 3 2 2 3 2 2 E
2 2 2 2 2 3 3 2 2 2 2 2 2 2 2 2 2 2 2 2 2 2 2 2 2 E
2 2 2 2 2 2 3 2 2 2 2 2 2 2 2 2 2 2 2 2 2 2 2 2 2 E
2 2 2 2 2 3 2 2 2 3 3 3 2 2 2 2 2 2 2 2 2 2 2 2 2 E
2 2 2 2 2 3 2 2 2 2 3 3 2 2 2 2 2 2 2 2 2 2 3 2 2 E
2 2 2 2 3 2 2 2 2 2 2 2 2 2 2 2 2 2 2 2 2 3 2 2 2 E
2 2 2 2 2 2 3 2 2 2 2 2 2 2 2 2 2 2 2 2 2 3 2 2 2 E
2 2 2 2 2 2 2 2 2 2 2 2 2 2 2 2 2 2 2 3 3 2 2 2 2 E
2 2 2 2 2 2 2 2 2 2 2 2 2 2 2 2 2 2 2 2 2 2 2 2 2 E
2 2 2 2 2 2 2 2 2 2 2 2 2 2 2 2 2 2 2 2 2 2 2 2 2 E
2 2 2 2 3 3 2 2 2 2 2 2 2 2 2 2 2 2 2 2 2 2 2 2 2 E
2 2 2 3 2 2 2 2 2 2 2 2 2 2 2 2 2 2 3 2 2 2 2 2 2 E
2 2 2 2 3 2 2 2 2 2 2 2 2 2 2 2 2 2 3 2 2 2 2 2 2 E
2 2 2 2 3 2 2 2 3 3 2 2 2 2 2 2 2 3 2 2 2 N 2 2 2 E
2 2 2 2 2 3 2 2 3 2 2 2 2 2 2 2 2 2 2 2 2 2 N 2 2 E
N N N N N N N N N N N N N N N N N N N N N N N N N E
N N N N N N N N N N N N N N N N N N N N N N N N N E
N N N N N N N N N N N N N N N N N N N N N N N N N E
N N N N N N N N N N N N N N N N N N N N N N N N N E
N N N N N N N N N N N N N N N N N N N N N N N N N E
N N N N N N N N N N N N N N N N N N N N N N N N N E
N N N N N N N N N N N N N N N N N N N N N N N N N E
N N N N N N N N N N N N N N N N N N N N N N N N N E
N N N N N N N N N N N N N N N N N N N N N N N N N E
N N N N N N N N N N N N N N N N N N N N N N N N N E
N N N N N N N N N N N N N N N N N N N N N N N N N E
N N N N N N N N N N N N N N N N N N N N N N N N N E
