2 3 3 2 2 2 2 2 2 2 2 2 2 2 2 2 2 2 2 2 2 2 2 2 2 N N N N E
2 3 3 2 2 2 2 2 2 2 2 2 2 2 2 2 2 2 2 2 3 3 2 2 2 N N N N E
2 2 2 2 2 3 3 2 2 2 2 2 2 2 2 2 2 2 2 3 2 2 3 2 2 N N N N E
2 2 2 2 2 3 3 2 2 2 2 3 3 3 3 2 2 2 2 3 2 2 3 2 2 N N N N E
2 2 2 2 2 3 3 2 2 2 2 2 2 2 2 2 2 2 2 2 2 2 2 2 2 N N N N E
2 2 2 2 2 3 3 2 2 3 3 3 3 3 2 2 2 2 2 2 2 2 2 2 2 N N N N E
2 2 2 2 2 3 3 2 2 3 3 3 3 3 2 2 2 2 2 2 2 2 2 2 2 N N N N E
2 2 2 2 2 3 3 2 2 3 3 3 3 3 2 2 2 2 2 2 2 2 3 2 2 N N N N E
2 2 2 2 2 3 3 2 2 3 3 3 3 3 2 2 2 2 2 2 2 3 2 2 2 N N N N E
2 2 2 2 2 3 3 2 2 2 2 2 2 2 2 2 2 2 2 2 2 3 2 2 2 N N N N E
2 2 2 2 2 3 3 2 2 2 2 2 2 2 2 2 2 2 2 3 3 2 2 2 2 N N N N E
2 2 2 2 2 2 2 2 2 2 2 2 2 2 2 2 2 2 2 2 2 2 2 2 2 N N N N E
2 2 2 2 2 2 2 2 2 2 2 2 2 2 2 2 2 2 2 2 2 2 2 2 2 N N N N E
2 2 2 3 3 3 2 2 2 2 2 2 2 2 2 2 2 2 2 2 2 2 2 2 2 2 2 2 N E
2 2 2 3 3 3 2 2 2 2 2 2 2 2 2 2 2 2 2 2 2 2 2 2 2 2 2 2 N E
2 2 2 3 3 3 2 2 2 2 2 2 2 2 2 2 2 2 2 2 2 2 2 2 2 2 2 2 N E
2 2 2 3 3 3 2 2 3 3 2 2 2 2 2 2 2 2 2 2 2 2 2 2 2 2 2 2 N E
2 2 2 3 3 3 2 2 3 3 2 2 2 2 2 2 2 2 2 2 2 2 2 2 2 2 2 2 N E
