111001111
111001111
141000111
114110111
141111111
